NO ./texture/rat.xpm
SO ./texture/horse.xpm
WE ./texture/dog.xpm
EA ./texture/rabbit.xpm

F 118,118,118
C 90,90,90

11111111111111111111 11111111111111111111
10000000000000000001 10000000000000000001
10000000000000000001 10000000000000000001
10001010101010101001 10001010101010101001
10000000000000000001 10000000000000000001
10000000000000001001 10000000000000001001
10000000000000001001 1000000000N000001001
10000000000000001001 10000000000000001001
10000000000001111001 10000000000001111001
10000000000000000001 10000000000000000001
10000000000000000001 10000000000000000001
10000000000000000001 10000000000000000001
11111111111111111111 11111111111111111111
