111111111111111
100000000000001
100000000000001
100000000000001
100001010101001
100000000000001
100011111000001
100000001000001
100000000000001
100000000000001
100000000000001
100000000000001
111111111111111
